%%%%%%%%%%%%%%%%%%%%%%
% %%                P%
%    %%%%%%%% %%%%%% %
%%% %%        %      %
%    % %%%%%% %% %%% %
% %%%% %         %   %
%        %%%%%%%   % %
%%%%%%%%%%    %%%%%% %
%.                   %
%%%%%%%%%%%%%%%%%%%%%%
