%%%%%
%...%
%...%
%..P%
%%%%%
